
      NO 			pics/wood.xpm
C  				200, 100 ,200
        EA 						 pics/marita_pequeña.xpm		
        WE pics/ice.xpm


       SO /Users/pmedina-/Documents/kub/pics/stone.xpm

       S /Users/pmedina-/Documents/kub/pics/rose.xpm


F 100, 200 , 100

       R  1080 720

    1111111111        
    10000000012          
    11111101111111        
    1000000001
    1000000011
    10000001
    1111N11
     1111111







