
NO 			./pics/wood.xpm
C  				200, 100 ,200
EA 						 pics/marita_pequeña.xpm		
WE pics/ice.xpm


SO /Users/pmedina-/Documents/cub/pics/stone.xpm

S /Users/pmedina-/Documents/cub/pics/rose.xpm


R  1080 720
F 100, 200 , 100 



    1111111111
    1000000001             
11111101111111
10000N0001
111111111