R 1920 1080

S ./pics/barrel.xpm     

NO ./pics/stone.xpm
SO ./pics/wood.xpm
WE ./pics/metal.xpm
EA 		./pics/bush.xpm  

C 200,200,100
F 200, 100, 200




1111111111111111
1222222222222221
1222222222222221
12222222N2222221
1222222222222221
1222222222222221
1111111111111111